**Snakey levels**
By: Ayinde-Oladeinde Ayoife
Do not alter or might cause weird bugs in the game

Rules for making levels
'==' is used for creating the name of the level
'#' represents the blocks/barriers
' ' (empty space) represents a free area
';' is used for creating comments about the level
Note: Each level should be a 20x20 character grid

==Blocked
####################
#                  #
#                  #
#                  #
#                  #
#                  #
#                  #
#                  #
#                  #
#                  #
#                  #
#                  #
#                  #
#                  #
#                  #
#                  #
#                  #
#                  #
#                  #
####################
;No way in or out :)

==DoubleWays
....................
....................
....................
....................
####################
....................
....................
....................
....................
....................
....................
....................
....................
....................
###########.........
....................
....................
....................
....................
....................
;Don't go and hit the barrier ;)

==Bodmas
....................
..............######
....................
...........#........
..........###.......
........#######.....
..........###.......
...........#........
....................
.....#....#.........
......#..#..........
.......##...........
.......##...........
......#..#..........
.....#....#.........
....................
....................
....................
....................
....................
;Math&Food

==OneWay
....................
....................
....................
....................
....................
....................
....................
....................
....................
####################
####################
....................
....................
....................
....................
....................
....................
....................
....................
....................
;Enjoy :)

==Stairs
##..................
.#..................
.###................
...#................
...####.............
......#.............
......#####.........
..........#.........
..........######....
...............#....
...............#####
...............#####
..........#.........
......#####.........
......#.............
...####.............
...#................
.###................
.#..................
##..................
; Enjoy :)

==Prison
....................
....................
....................
....................
....................
....................
..###############...
..#.............#...
..#.............#...
..#..#########..#...
..#.............#...
..#.............#...
..###########...#...
....................
....................
....................
....................
....................
....................
....................
;Enjoy :)

==V-Shape
....................
....................
....................
....................
...#...........#....
....#.........#.....
.....#.......#......
......#.....#.......
.......#...#........
........###.........
....................
....................
....................
....................
....................
....................
....................
....................
....................
....................